#b1........b1
#b1........b1
#b1........b1
#b1........b1
#b1........b1
#b1........b1
#b1t1t1....b1
#b1t1t1....b1
#b1t1t1....b1
#b1m1m1....b1
#b1........b1
#b1........b1
#b1....t1t1b1
#b1....t1t1b1
#b1....m1m1b1
#b1........b1
#b1........b1
#b1t1t1....b1
#b1t1t1....b1
#b1m1m1....b1
#b1........b1
#b1....t1t1b1
#b1....t1t1b1
#b1....m1m1b1
#b1........b1
#b1........b1
#b1........b1
#b1m1m1....b1
#b1t2......b1
#b1........b1
#b1....t1t1b1
#b1....t1t1b1
#b1....m1m1b1
#b1........b1
#b1........b1
#b1........b1
#b1m1m1....b1
#b1........b1
#b1......t1b1
#b1......t1b1
#b1....m1m1b1
#b1........b1
#b1........b1
#b1........b1
#b1..m1....b1
#b1........b1
#b1........b1
#b1........b1
#b1m1m1....b1
#b1........b1
#b1........b1
#b1..t1..m1b1
#b1..t1....b1
#b1..t1....b1
#b1..t1....b1
#b1..m1....b1
#b1........b1
#b1........b1
#b1........b1
#b1......m1b1
#b1........b1
#b1........b1
#b1........b1
#b1......m1b1
#b1........b1
#b1........b1
#b1t1......b1
#b1t1....m1b1
#b1t1......b1
#b1t1......b1
#b1m1......b1
#b1........b1
#b1........b1
#b1....m1..b1
#b1........b1
#b1........b1
#b1m1......b1
#b1........b1
#b1....m1..b1
#b1t1......b1
#b1t1......b1
#b1m1m1m1..b1
#b1........b1
#b1........b1
#b1......m1b1
#b1........b1
#b1........b1
#b1t1......b1
#b1t1......b1
#b1m1......b1
#b1........b1
#b1........b1
#b1........b1
#b1....m1..b1
#b1........b1
#b1........b1
#b1......m1b1
#b1........b1
#b1........b1
#b1........b1
#b1........b1
#b1b1b1b1b1b1

