


#m1m1m1m1m1|m1m1m1m1m1|m1m1m1m1m1|m1........|m1m1m1m1m1|m1m1m1m1m1|
#b1b1b1b1b1|b1b1b1b1b1|b1b1b1b1b1|b1b1....b1|b1b1b1b1b1|b1b1b1b1b1|
#st........|st........|st........|st........|st........|st........|
#sm........|sm........|sm........|sm........|sm........|sm........|
#sb........|sb........|sb........|sb........|sb........|sb........|
#b1b1b1b1b1|b1b1b1b1b1|b1b1b1b1b1|b1b1....b1|b1b1b1b1b1|b1b1b1b1b1|
#st........|st........|st........|st........|st........|st........|
#sm........|sm........|sm........|sm........|sm........|sm........|
#sb........|sb........|sb........|sb........|sb........|sb........|
#b1b1b1b1b1|b1b1....b1|b1b1b1b1b1|b1b1b1b1b1|b1b1b1b1b1|b1b1b1b1b1|
#st........|st........|st........|st........|st........|st........|
#sm........|sm........|sm........|sm........|sm........|sm........|
#sb........|sb........|sb........|sb........|sb........|sb........|
#b1b1b1b1b1|b1b1b1b1b1|b1b1b1b1b1|b1b1....b1|b1b1b1b1b1|b1b1b1b1b1|
#st........|st........|st........|st........|st........|st........|
#sm........|sm........|sm........|sm........|sm........|sm........|
#sb........|sb........|sb........|sb........|sb........|sb........|
#b1b1b1b1b1|b1b1b1b1b1|b1b1b1b1b1|b1b1....b1|b1b1b1b1b1|b1b1b1b1b1|
#st........|st........|st........|st........|st........|st........|
#sm........|sm........|sm........|sm........|sm........|sm........|
#sb........|sb........|sb........|sb........|sb........|sb........|
#b1b1b1b1b1|b1b1b1b1b1|b1b1b1b1b1|b1b1....b1|b1b1b1b1b1|b1b1b1b1b1|
#st........|st........|st........|st........|st........|st........|
#sm........|sm........|sm........|sm........|sm........|sm........|
#sb........|sb........|sb........|sb........|sb........|sb........|
#b1b1b1b1b1|b1b1b1b1b1|b1b1b1b1b1|b1b1b1b1b1|b1b1b1b1b1|b1b1b1b1b1|
*
#m1m1m1m1m1|m1m1m1m1m1|m1m1m1m1m1|m1........|m1m1m1m1m1|m1m1m1m1m1|
#b1b1b1b1b1|b1b1b1b1b1|b1b1b1b1b1|b1b1....b1|b1b1b1b1b1|b1b1b1b1b1|
#st........|st........|st........|st........|st........|st........|
#sm........|sm........|sm........|sm........|sm........|sm........|
#sb........|sb........|sb........|sb........|sb........|sb........|
#b1b1b1b1b1|b1b1b1b1b1|b1b1b1b1b1|b1b1....b1|b1b1b1b1b1|b1b1b1b1b1|
#st........|st........|st........|st........|st........|st........|
#sm........|sm........|sm........|sm........|sm........|sm........|
#sb........|sb........|sb........|sb........|sb........|sb........|
#b1b1b1b1b1|b1b1....b1|b1b1b1b1b1|b1b1b1b1b1|b1b1b1b1b1|b1b1b1b1b1|
#st........|st........|st........|st........|st........|st........|
#sm........|sm........|sm........|sm........|sm........|sm........|
#sb........|sb........|sb........|sb........|sb........|sb........|
#b1b1b1b1b1|b1b1b1b1b1|b1b1b1b1b1|b1b1....b1|b1b1b1b1b1|b1b1b1b1b1|
#st........|st........|st........|st........|st........|st........|
#sm........|sm........|sm........|sm........|sm........|sm........|
#sb........|sb........|sb........|sb........|sb........|sb........|
#b1b1b1b1b1|b1b1b1b1b1|b1b1b1b1b1|b1b1....b1|b1b1b1b1b1|b1b1b1b1b1|
#st........|st........|st........|st........|st........|st........|
#sm........|sm........|sm........|sm........|sm........|sm........|
#sb........|sb........|sb........|sb........|sb........|sb........|
#b1b1b1b1b1|b1b1b1b1b1|b1b1b1b1b1|b1b1....b1|b1b1b1b1b1|b1b1b1b1b1|
#st........|st........|st........|st........|st........|st........|
#sm........|sm........|sm........|sm........|sm........|sm........|
#sb........|sb........|sb........|sb........|sb........|sb........|
#b1b1b1b1b1|b1b1b1b1b1|b1b1b1b1b1|b1b1b1b1b1|b1b1b1b1b1|b1b1b1b1b1|
*
#m1m1m1m1m1|m1m1m1m1m1|m1m1m1m1m1|m1........|m1m1m1m1m1|m1m1m1m1m1|
#b1b1b1b1b1|b1b1b1b1b1|b1b1b1b1b1|b1b1....b1|b1b1b1b1b1|b1b1b1b1b1|
#st........|st........|st........|st........|st........|st........|
#sm........|sm........|sm........|sm........|sm........|sm........|
#sb........|sb........|sb........|sb........|sb........|sb........|
#b1b1b1b1b1|b1b1b1b1b1|b1b1b1b1b1|b1b1....b1|b1b1b1b1b1|b1b1b1b1b1|
#st........|st........|st........|st........|st........|st........|
#sm........|sm........|sm........|sm........|sm........|sm........|
#sb........|sb........|sb........|sb........|sb........|sb........|
#b1b1b1b1b1|b1b1....b1|b1b1b1b1b1|b1b1b1b1b1|b1b1b1b1b1|b1b1b1b1b1|
#st........|st........|st........|st........|st........|st........|
#sm........|sm........|sm........|sm........|sm........|sm........|
#sb........|sb........|sb........|sb........|sb........|sb........|
#b1b1b1b1b1|b1b1b1b1b1|b1b1b1b1b1|b1b1....b1|b1b1b1b1b1|b1b1b1b1b1|
#st........|st........|st........|st........|st........|st........|
#sm........|sm........|sm........|sm........|sm........|sm........|
#sb........|sb........|sb........|sb........|sb........|sb........|
#b1b1b1b1b1|b1b1b1b1b1|b1b1b1b1b1|b1b1....b1|b1b1b1b1b1|b1b1b1b1b1|
#st........|st........|st........|st........|st........|st........|
#sm........|sm........|sm........|sm........|sm........|sm........|
#sb........|sb........|sb........|sb........|sb........|sb........|
#b1b1b1b1b1|b1b1b1b1b1|b1b1b1b1b1|b1b1....b1|b1b1b1b1b1|b1b1b1b1b1|
#st........|st........|st........|st........|st........|st........|
#sm........|sm........|sm........|sm........|sm........|sm........|
#sb........|sb........|sb........|sb........|sb........|sb........|
#b1b1b1b1b1|b1b1b1b1b1|b1b1b1b1b1|b1b1b1b1b1|b1b1b1b1b1|b1b1b1b1b1|
*
#m1m1m1m1m1|m1m1m1m1m1|m1m1m1m1m1|m1........|m1m1m1m1m1|m1m1m1m1m1|
#b1b1b1b1b1|b1b1b1b1b1|b1b1b1b1b1|b1b1....b1|b1b1b1b1b1|b1b1b1b1b1|
#st........|st........|st........|st........|st........|st........|
#sm........|sm........|sm........|sm........|sm........|sm........|
#sb........|sb........|sb........|sb........|sb........|sb........|
#b1b1b1b1b1|b1b1b1b1b1|b1b1b1b1b1|b1b1....b1|b1b1b1b1b1|b1b1b1b1b1|
#st........|st........|st........|st........|st........|st........|
#sm........|sm........|sm........|sm........|sm........|sm........|
#sb........|sb........|sb........|sb........|sb........|sb........|
#b1b1b1b1b1|b1b1....b1|b1b1b1b1b1|b1b1b1b1b1|b1b1b1b1b1|b1b1b1b1b1|
#st........|st........|st........|st........|st........|st........|
#sm........|sm........|sm........|sm........|sm........|sm........|
#sb........|sb........|sb........|sb........|sb........|sb........|
#b1b1b1b1b1|b1b1b1b1b1|b1b1b1b1b1|b1b1....b1|b1b1b1b1b1|b1b1b1b1b1|
#st........|st........|st........|st........|st........|st........|
#sm........|sm........|sm........|sm........|sm........|sm........|
#sb........|sb........|sb........|sb........|sb........|sb........|
#b1b1b1b1b1|b1b1b1b1b1|b1b1b1b1b1|b1b1....b1|b1b1b1b1b1|b1b1b1b1b1|
#st........|st........|st........|st........|st........|st........|
#sm........|sm........|sm........|sm........|sm........|sm........|
#sb........|sb........|sb........|sb........|sb........|sb........|
#b1b1b1b1b1|b1b1b1b1b1|b1b1b1b1b1|b1b1....b1|b1b1b1b1b1|b1b1b1b1b1|
#st........|st........|st........|st........|st........|st........|
#sm........|sm........|sm........|sm........|sm........|sm........|
#sb........|sb........|sb........|sb........|sb........|sb........|
#b1b1b1b1b1|b1b1b1b1b1|b1b1b1b1b1|b1b1b1b1b1|b1b1b1b1b1|b1b1b1b1b1|
*
#m1m1m1m1m1|m1m1m1m1m1|m1m1m1m1m1|m1........|m1m1m1m1m1|m1m1m1m1m1|
#b1b1b1b1b1|b1b1b1b1b1|b1b1b1b1b1|b1b1....b1|b1b1b1b1b1|b1b1b1b1b1|
#st........|st........|st........|st........|st........|st........|
#sm........|sm........|sm........|sm........|sm........|sm........|
#sb........|sb........|sb........|sb........|sb........|sb........|
#b1b1b1b1b1|b1b1b1b1b1|b1b1b1b1b1|b1b1....b1|b1b1b1b1b1|b1b1b1b1b1|
#st........|st........|st........|st........|st........|st........|
#sm........|sm........|sm........|sm........|sm........|sm........|
#sb........|sb........|sb........|sb........|sb........|sb........|
#b1b1b1b1b1|b1b1....b1|b1b1b1b1b1|b1b1b1b1b1|b1b1b1b1b1|b1b1b1b1b1|
#st........|st........|st........|st........|st........|st........|
#sm........|sm........|sm........|sm........|sm........|sm........|
#sb........|sb........|sb........|sb........|sb........|sb........|
#b1b1b1b1b1|b1b1b1b1b1|b1b1b1b1b1|b1b1....b1|b1b1b1b1b1|b1b1b1b1b1|
#st........|st........|st........|st........|st........|st........|
#sm........|sm........|sm........|sm........|sm........|sm........|
#sb........|sb........|sb........|sb........|sb........|sb........|
#b1b1b1b1b1|b1b1b1b1b1|b1b1b1b1b1|b1b1....b1|b1b1b1b1b1|b1b1b1b1b1|
#st........|st........|st........|st........|st........|st........|
#sm........|sm........|sm........|sm........|sm........|sm........|
#sb........|sb........|sb........|sb........|sb........|sb........|
#b1b1b1b1b1|b1b1b1b1b1|b1b1b1b1b1|b1b1....b1|b1b1b1b1b1|b1b1b1b1b1|
#st........|st........|st........|st........|st........|st........|
#sm........|sm........|sm........|sm........|sm........|sm........|
#sb........|sb........|sb....p0..|sb........|sb........|sb........|
#b1b1b1b1b1|b1b1b1b1b1|b1b1b1b1b1|b1b1b1b1b1|b1b1b1b1b1|b1b1b1b1b1|



