#b1........b1
#b1........b1
#b1........b1
#b1........b1
#b1........b1
#b1........b1
#b1t1t1....b1
#b1t1t1....b1
#b1t1t1....b1
#b1m2m2....b1
#b1........b1
#b1........b1
#b1....t1t1b1
#b1....t1t1b1
#b1....m2m2b1
#b1........b1
#b1........b1
#b1t1t1....b1
#b1t1t1....b1
#b1m2m2....b1
#b1........b1
#b1....t1t1b1
#b1....t1t1b1
#b1....m2m2b1
#b1........b1
#b1........b1
#b1........b1
#b1m2m2....b1
#b1t2......b1
#b1........b1
#b1....t1t1b1
#b1....t1t1b1
#b1....m2m2b1
#b1........b1
#b1........b1
#b1........b1
#b1m2m2....b1
#b1........b1
#b1......t1b1
#b1......t1b1
#b1....m2m2b1
#b1........b1
#b1........b1
#b1........b1
#b1..m2....b1
#b1........b1
#b1........b1
#b1........b1
#b1m2m2....b1
#b1........b1
#b1........b1
#b1..t1..m2b1
#b1..t1....b1
#b1..t1....b1
#b1..t1....b1
#b1..m2....b1
#b1........b1
#b1........b1
#b1........b1
#b1......b1b1
#b1........b1
#b1........b1
#b1........b1
#b1......m2b1
#b1........b1
#b1........b1
#b1t1......b1
#b1t1....m2b1
#b1t1......b1
#b1t1......b1
#b1m2......b1
#b1........b1
#b1........b1
#b1....m2..b1
#b1........b1
#b1........b1
#b1m2......b1
#b1........b1
#b1....m2..b1
#b1t1......b1
#b1t1......b1
#b1m2m2m2..b1
#b1........b1
#b1........b1
#b1......m2b1
#b1........b1
#b1........b1
#b1t1......b1
#b1t1......b1
#b1m2......b1
#b1........b1
#b1........b1
#b1........b1
#b1....m2..b1
#b1........b1
#b1........b1
#b1....m2m2b1
#b1........b1
#b1........b1
#b1........b1
#b1........b1
#b1b1b1b1b1b1